You are in a ship travelling through space on a mission to save your home planet.  You have been fighting off many other people on this journey.

Suddenly, a ship comes at you at full speed.  It powers up its lasers, all three of them.  Each laser hits one of you rooms - Engine Room, Oxygen Room, and Reactor Room.

You quickly reach for your communication devices, and you ask them to stop attacking you.  They respond apoligizing because they thought you were going to attack them first.  They then beam over a wrench to help you fix the systems on your ship.

Fix the Ship
An Interactive Fiction by Kyle Axt
Release 1 / Serial number 141007 / Inform 7 build 6L38 (I6/v6.33 lib 6/12N) SD

Cockpit
This is the area where you have full control over your ship.  You can control the engines, reactor, oxygen, and many other things.  You can also see the position of other ships around you and communicate with them.

The oxygen, engine room, and reactor are flashing red.  You really need to fix these now.

To the west is the Storage Room

>w
Storage Room
The storage room is the room where you keep all of your stuff.  Everything is kept neatly organized in boxes for tools, parts, and scrap.  Storage Box #1 is filled with parts to fix the oxygen room and the engine room.  Storage Box #2 is filled with parts to fix the reactor, but you seemed to have lost the key somewhere.

To the north is the Oxygen Room, west is the Engine Room, south is the Reactor Room, and east is the Cockpit.

>open storage box #1
You open Storage Box #1, revealing Engine Parts and Oxygen Pipes.

>get all
Engine Parts: Taken.
Oxygen Pipes: Taken.

>n
Oxygen Room
This room provides oxygen.  It providea all the oxygen to support all lifeforms on your ship.  If this goes down you better fix it quick.  The oxygen system is in the room.

>fix oxygen
(Oxygen Pipes)

>fix oxygen system
The Oxygen System is fixed.  You have obtained the Storage Box Key.

>s
Storage Room
The storage room is the room where you keep all of your stuff.  Everything is kept neatly organized in boxes for tools, parts, and scrap.  Storage Box #1 is filled with parts to fix the oxygen room and the engine room.  Storage Box #2 is filled with parts to fix the reactor, but you seemed to have lost the key somewhere.

To the north is the Oxygen Room, west is the Engine Room, south is the Reactor Room, and east is the Cockpit.

>w
Engine Room
The is the room where the engine power comes from.  If this is broken or has no power you can't move at all.  The ship engine is in the room.

>fix engine
(Engine Parts)

>fix system engine
The Engine is fixedYou didn't need all the parts to fix the engine, so you have recieved some spare parts.

>e
Storage Room
The storage room is the room where you keep all of your stuff.  Everything is kept neatly organized in boxes for tools, parts, and scrap.  Storage Box #1 is filled with parts to fix the oxygen room and the engine room.  Storage Box #2 is filled with parts to fix the reactor, but you seemed to have lost the key somewhere.

To the north is the Oxygen Room, west is the Engine Room, south is the Reactor Room, and east is the Cockpit.

>s
Reactor Room
This is the reactor room.  It provides the power for everything in your ship.  There is a reactor in the middle of the room.

>fix reacotr
You can't see any such thing.

>fix reactor
you need the Reactor Part

>n
Storage Room
The storage room is the room where you keep all of your stuff.  Everything is kept neatly organized in boxes for tools, parts, and scrap.  Storage Box #1 is filled with parts to fix the oxygen room and the engine room.  Storage Box #2 is filled with parts to fix the reactor, but you seemed to have lost the key somewhere.

To the north is the Oxygen Room, west is the Engine Room, south is the Reactor Room, and east is the Cockpit.

>open storage box #2
It seems to be locked.

>unlock storage box #2 with box key
You unlock Storage Box #2.

>open storage box #2
You open Storage Box #2, revealing Reactor Part.

>get part
Taken.

>s
Reactor Room
This is the reactor room.  It provides the power for everything in your ship.  There is a reactor in the middle of the room.

>fix reactor
(Reactor Part)

>fix system reactor
    *** Good Job, Your Ship is now fully functioning again. ***

Would you like to RESTART, RESTORE a saved game, QUIT or UNDO the last command?

* * *

>w
Storage Room
The storage room is the room where you keep all of your stuff.  Everything is kept neatly organized in boxes for tools, parts, and scrap.  Storage Box #1 is filled with parts to fix the oxygen room and the engine room.  Storage Box #2 is filled with parts to fix the reactor, but you seemed to have lost the key somewhere.

To the north is the Oxygen Room, west is the Engine Room, south is the Reactor Room, and east is the Cockpit.

>w
Engine Room
The is the room where the engine power comes from.  If this is broken or has no power you can't move at all.  The ship engine is in the room.

>e
Storage Room

>n
Oxygen Room

>s
Storage Room

>s
Reactor Room

* * *

>w
Engine Room
The is the room where the engine power comes from.  If this is broken or has no power you can't move at all.  The ship engine is in the room.

>x engine
MODEL #: RE-514

This is the engine of your ship.  It appears to be broken from the attacking ship.  Maybe you can fix it.

* * *

>w
Storage Room
The storage room is the room where you keep all of your stuff.  Everything is kept neatly organized in boxes for tools, parts, and scrap.  Storage Box #1 is filled with parts to fix the oxygen room and the engine room.  Storage Box #2 is filled with parts to fix the reactor, but you seemed to have lost the key somewhere.

To the north is the Oxygen Room, west is the Engine Room, south is the Reactor Room, and east is the Cockpit.

>x storage box#2
I only understood you as far as wanting to examine Storage Box #1.

>x storage box #1
Parts to fix the oxygen room and the engine room.

>x storage box
Parts to fix the oxygen room and the engine room.

>open storage box
You open Storage Box #1, revealing Engine Parts and Oxygen Pipes.

>get all
Engine Parts: Taken.
Oxygen Pipes: Taken.

* * *

>w
Storage Room
The storage room is the room where you keep all of your stuff.  Everything is kept neatly organized in boxes for tools, parts, and scrap.  Storage Box #1 is filled with parts to fix the oxygen room and the engine room.  Storage Box #2 is filled with parts to fix the reactor, but you seemed to have lost the key somewhere.

To the north is the Oxygen Room, west is the Engine Room, south is the Reactor Room, and east is the Cockpit.

>open storage box #2
It seems to be locked.

* * *

>take all
You can't see any such thing.

>w
Storage Room
The storage room is the room where you keep all of your stuff.  Everything is kept neatly organized in boxes for tools, parts, and scrap.  Storage Box #1 is filled with parts to fix the oxygen room and the engine room.  Storage Box #2 is filled with parts to fix the reactor, but you seemed to have lost the key somewhere.

To the north is the Oxygen Room, west is the Engine Room, south is the Reactor Room, and east is the Cockpit.

>open box 1
Which do you mean, Storage Box #1 or Storage Box #2?

>open storage box 1
Which do you mean, Storage Box #1 or Storage Box #2?

>open storage #1
You open Storage Box #1, revealing Engine Parts and Oxygen Pipes.

>take all
Engine Parts: Taken.
Oxygen Pipes: Taken.

>open storage box #2
It seems to be locked.

>w
Engine Room
The is the room where the engine power comes from.  If this is broken or has no power you can't move at all.  The ship engine is in the room.

* * *

>fix engine
(Engine Parts)

>fix engine
(Engine Parts)

>fix engine with engine parts
You can't see any such thing.

>fix engine
(Engine Parts)

>e
Storage Room
The storage room is the room where you keep all of your stuff.  Everything is kept neatly organized in boxes for tools, parts, and scrap.  Storage Box #1 is filled with parts to fix the oxygen room and the engine room.  Storage Box #2 is filled with parts to fix the reactor, but you seemed to have lost the key somewhere.

To the north is the Oxygen Room, west is the Engine Room, south is the Reactor Room, and east is the Cockpit.

>n
Oxygen Room
This room provides oxygen.  It providea all the oxygen to support all lifeforms on your ship.  If this goes down you better fix it quick.  The oxygen system is in the room.

>x oxygen system
MODEL #: KBM-7924

This provides the oxygen for your ship.  The system is broken from the blast of the attacking ship.

>fix kbm-7924
You're gonna need a wrench

* * *

>i
You are carrying:
  Wrench

>w
Storage Room
The storage room is the room where you keep all of your stuff.  Everything is kept neatly organized in boxes for tools, parts, and scrap.  Storage Box #1 is filled with parts to fix the oxygen room and the engine room.  Storage Box #2 is filled with parts to fix the reactor, but you seemed to have lost the key somewhere.

To the north is the Oxygen Room, west is the Engine Room, south is the Reactor Room, and east is the Cockpit.

>x storage box
Which do you mean, Storage Box #1 or Storage Box #2?

>x storage box 1
You can't see any such thing.

>x storage box #1
Parts to fix the oxygen room and the engine room.

>get parts
You can't see any such thing.

>get al
You can't see any such thing.

>get all
(Wrench)
You already have that.

>open storage box #1
You open Storage Box #1, revealing Engine Parts and Oxygen Pipes.

>get parts
Taken.

>get pipes
Taken.

>n
Oxygen Room
This room provides oxygen.  It providea all the oxygen to support all lifeforms on your ship.  If this goes down you better fix it quick.  The oxygen system is in the room.

>fix oxygen system
The Oxygen System is fixed.  You have obtained the Storage Box Key.